#Forward	Barcode	Spacer
SF1	AAGACA	AAGACA
SF2	TCTATT	TCTATTG
SF3	ATAGAT	ATAGATGA
SF4	CTAGTA	CTAGTACGA
SF5	AGTTCT	AGTTCTATGA
SF6	TGATAT	TGATATACTTA
SF7	TTATGA	TTATGATACGGA
SF8	ACTATT	ACTATTTGACTGA
#Reverse	Barcode	Spacer
SR1	TACGGC	TACGGC
SR2	ACGGAG	ACGGAGC
SR3	GCCACG	GCCACGTC
SR4	CTGCTC	CTGCTCGTC
SR5	GAGCAG	GAGCAGCCTG
SR6	GGCTTC	GGCTTCAGGTA
SR7	GGTCAG	GGTCAGCACGTT
SR8	TTGCGC	TTGCGCATACGAA
SR9	CGCTCA	CGCTCAGGTAAGGA
SR10	CATCGC	CATCGCAAGTCCTTA
SR11	GCAGCA	GCAGCATAAATGTGGT
SR12	CACAGG	CACAGGTTACACACTAA
