#Forward	Barcode	Spacer
SF1	AAGACA	AAGACA
SF2	TCTATT	TCTATT
SF3	ATAGAT	ATAGAT
SF4	CTAGTA	CTAGTA
SF5	AGTTCT	AGTTCT
SF6	TGATAT	TGATAT
SF7	TTATGA	TTATGA
SF8	ACTATT	ACTATT
#Reverse	Barcode	Spacer
SR1	TACGGC	TACGGC
SR2	ACGGAG	ACGGAG
SR3	GCCACG	GCCACG
SR4	CTGCTC	CTGCTC
SR5	GAGCAG	GAGCAG
SR6	GGCTTC	GGCTTC
SR7	GGTCAG	GGTCAG
SR8	TTGCGC	TTGCGC
SR9	CGCTCA	CGCTCA
SR10	CATCGC	CATCGC
SR11	GCAGCA	GCAGCA
SR12	CACAGG	CACAGG
